wwwwwwwwwwwwwwwwwwww
wGGwGGGGGGGGGGGGGGGw
wGGwGGGGGGGGGGGGGGGw
wGGwGGGGGGGGGGGGGGGw
wGGGGGGGGGGGGGGGGGGw
wGGGGGGGGGGGGGGGGGGw
wGGGGGGGGGGGGGGGGGGw
wGGGGGGGGGGGGGGGGGGw
wGGGGGGGGG1GGGGGGGGw
wGGGGGGGGGGGGGGGGGGw
wGGGGGGGGGGGGGGGGGGw
wGGGGGGGGGGGGGGGGGGw
wGGGGGGGGGGGGGGGGGGw
wGGGGGGGGGGGGGGGGGGw
wwwwwwwwwwwwwwwwwwww